politics	politics
religion	religion
computer	computer
autos.sports	autos.sports
science	science
sales	sales
talk.politics.guns	talk.politics.guns
talk.politics.mideast	talk.politics.mideast
talk.politics.misc	talk.politics.misc
alt.atheism	alt.atheism
soc.religion.christian	soc.religion.christian
talk.religion.misc	talk.religion.misc
comp.sys.ibm.pc.hardware	comp.sys.ibm.pc.hardware
comp.sys.mac.hardware	comp.sys.mac.hardware
comp.graphics	comp.graphics
comp.windows.x	comp.windows.x
comp.os.ms.windows.misc	comp.os.ms.windows.misc
rec.autos	rec.autos
rec.motorcycles	rec.motorcycles
rec.sport.baseball	rec.sport.baseball
rec.sport.hockey	rec.sport.hockey
sci.electronics	sci.electronics
sci.crypt	sci.crypt
sci.med	sci.med
sci.space	sci.space
misc.forsale	misc.forsale
